/*
ROOT, CHAT, CONTACTLIST - src/Component/Layout
Footer, Header, Main - src/Component/Template (UpperLayer - ложится поверх Main)

 ---------------------------------------ROOT--------------------------------------
|                                                                                 |
|   ###########################################################################   |
|   #                                  Header                                 #   |
|   ###########################################################################   |
|   #                                                                         #   |
|   #                                   Main                                  #   |
|   #                                                                         #   |
|   #    ------CHATLIST------ --------------------CHAT--------------------    #   |
|   #   |                    |                                            |   #   |
|   #   |   ##############   |   ######################################   |   #   |
|   #   |   #   Header   #   |   #               Header               #   |   #   |
|   #   |   ##############   |   ######################################   |   #   |
|   #   |   #            #   |   #                                    #   |   #   |
|   #   |   #            #   |   #                                    #   |   #   |
|   #   |   #            #   |   #                                    #   |   #   |
|   #   |   #    Main    #   |   #                Main                #   |   #   |
|   #   |   #            #   |   #                                    #   |   #   |
|   #   |   #            #   |   #                                    #   |   #   |
|   #   |   #            #   |   #                                    #   |   #   |
|   #   |   ##############   |   ######################################   |   #   |
|   #   |   #   Footer   #   |   #               Footer               #   |   #   |
|   #   |   ##############   |   ######################################   |   #   |
|   #    -------------------- --------------------------------------------    #   |
|   #                                                                         #   |
|   ###########################################################################   |
|   #                                  Footer                                 #   |
|   ###########################################################################   |
 ---------------------------------------------------------------------------------
*/